000000000000000000000000000
000000000000000000000000000
111111111111111111111111111
422222222222222222222222223
111111111111111111111111111
000000000000000000000000000
000000000000000000000000000